....................................................................
   **************   *  *** **  *      ******************************
  ********************* ** ** *  * ****************************** *
 **      *****************       ******************************
          *************          **  * **** ** ************** *
           *********            *******   **************** * *
            ********           ***************************  *
   *        * **** ***         *************** ******  ** *
               ****  *         ***************   *** ***  *
                 ******         *************    **   **  *
                 ********        *************    *  ** ***
                   ********         ********          * *** ****
                   *********         ******  *        **** ** * **
                   *********         ****** * *           *** *   *
                     ******          ***** **             *****   *
                     *****            **** *            ********
                    *****             ****              *********
                    ****              **                 *******   *
                    ***                                       *    *
                    **     *                    *
....................................................................